1111111111111111111111111111111111
1EX000000000000C00000C00000X000001
1010010100100000101001000000010101
101001001010101000100100000001C101
1P0000000C00C00000000000X0000010C1
1111111111111111111111111111111111