1111111111111
10X1000000001
1000010111001
1P0011E0000X1
1111111111111