111111111111111111111111111111111111111
1EX000000000000C00000C00000X00000111111
101001010010000010100100000001010111111
101001001010101000100100000001C10111111
1P0000000C00C00000000000X0000010C111111
111111111111111111111111111111111111111
111111111111111111111111111111111111111
111111111111111111111111111111111111111
111111111111111111111111111111111111111
111111111111111111111111111111111111111
111111111111111111111111111111111111111
111111111111111111111111111111111111111
111111111111111111111111111111111111111
111111111111111111111111111111111111111
111111111111111111111111111111111111111
111111111111111111111111111111111111111
111111111111111111111111111111111111111