111111111111111111111111111111
1P1000100010001000100010001CE1
101010101010101010101010101CC1
101010101010101010101010101CC1
101010101010101010101010101CC1
101010101010101010101010101CC1
101010101010101010101010101CC1
101010101010101010101010101CC1
101010101010101010101010101CC1
101010101010101010101010101CC1
101010101010101010101010101CC1
101010101010101010101010101CC1
101010101010101010101010101CC1
101010101010101010101010101CC1
100010001000100010001000100CC1
111111111111111111111111111111