1111111
1P000C1
101X101
10000E1
1111111