1111111111111
1CX10000000C1
10C0011111001
1P0011E1000X1
1111111111111