1111111111111
1CX10000000C1
10C0010111001
1P0011E0E00X1
1111111011111